19 x 19
*******************
* S *   *         *
* * * * * * *******
* * * *   * *     *
* *** ***** * *** *
*   *     * *   * *
* * ***** * *** * *
* *   *   *   * * *
*** *** ***** * * *
*   *   *   *   * *
* *** ***** *******
*     *           *
* ***** ********* *
*       *       * *
********* ***** * *
*  F    * *   * * *
* *** *** * * * * *
*   *       * *   *
*******************